#########################
#.......................#
#.......................#
#.......................#
#.......................#
#.......................#
#.......................#
#..........#............#
#..........#............#
#..........#............#
#..........#............#
a..........#............#
#..........#............#
b..........#............#
#..........#............#
#.......................#
#.......................#
#.......................#
#.......................#
#.......................#
#.......................#
#.......................#
#.......................#
#.......................#
##########B##############
