#########################
#.......................#
#.......................#
#.......................#
#.......................#
#.......................#
#.......................#
#..........#............#
#..........#............#
#..........#............#
#..........#............#
#..........#............#
#..........#............#
#..........#............#
#..........#............#
#.......................#
#.......................#
#.......................#
#.......................#
a.......................#
#.......................#
#.......................#
#.......................#
#.......................#
##########B##############
