##################b#####
#.......................#
#.......................#
#.......................#
#.......................#
#.......................#
#.......................#
#........###............#
#..........#............#
#..........#............#
#........###............#
C........#..............#
#........#..............#
#........#..............#
#........###............#
#.......................#
#.......................#
#.......................#
#.......................#
#.......................#
#.......................#
#.......................#
#.......................#
#.......................#
#########################
