###########ee############
#.......................#
#.......................#
#.......................#
#.......................#
#.......................#
#.......................#
#........###............#
#..........#............#
#..........#............#
q........###............#
q........#..............#
#........#..............#
#........#..............#
#........###............#
#.......................#
#.......................#
#.......................#
#.......................#
#.......................#
#.......................#
#.......................#
#.......................#
#.......................#
#########################
