##########qq#############
#.......................#
#.......................#
#.......................#
#.......................#
#.......................#
#.......................#
#........###............#
#..........#............#
#..........#............#
#........###............e
#..........#............e
#..........#............#
#........###............#
#.......................#
#.......................#
#.......................#
#.......................#
#.......................#
#.......................#
#.......................#
#.......................#
#.......................#
#.......................#
#########################
