############c###########
#.......................#
#.......................#
#.......................#
#.......................#
#.......................#
#.......................#
#........###............#
#..........#............#
#..........#............#
#........###............#
D........#..............#
#........#..............#
#........#..............#
#........###............#
#.......................#
#.......................#
#.......................#
#.......................#
#.......................#
#.......................#
#.......................#
#.......................#
#.......................#
#########################
