#########################
#.......................#
#.......................#
#.......................#
#.......................#
#.......................#
#.......................#
#........###............#
#..........#............#
#..........#............#
#........###............#
#..........#............d
#..........#............#
#........###............#
#.......................#
#.......................#
#.......................#
#.......................#
#.......................#
#.......................#
#.......................#
#.......................#
#.......................#
#.......................#
#########################
