#########################
#.......................#
#.......................#
#.......................#
#.......................#
#.......................#
#.......................#
#..........#............#
#..........#............#
#..........#............#
e..........#............#
e..........#............#
#..........#............#
#..........#............#
#..........#............#
#.......................#
#.......................#
#.......................#
#.......................#
#.......................#
#.......................#
#.......................#
#.......................#
#.......................#
##########qq#############
